000000000000000
000000030000000
000000444000000
000005555500000
000011111110000
000222222222000
003333333333300
044444444444440
555555555555555
000000000000000
000000000000000
000000000000000
000000000000000
000000000000000
000000000000000