000000000000000
011110000011110
011111000111110
011111111111110
001111111111100
000111111111000
000011111110000
000001111100000
000000111000000
000000010000000
000000000000000
000000000000000
000000000000000
000000000000000
000000000000000