000000010000000
000000121000000
000001232100000
000012343210000
000123454321000
001234505432100
012345000543210
123450000054321
012345000543210
001234505432100
000123454321000
000012343210000
000001232100000
000000121000000
000000010000000