000000000000000
000000000000000
022220000022220
033333000333330
044444444444440
004444444444400
000444444444000
000055555550000
000005555500000
000000111000000
000000010000000
000000000000000
000000000000000
000000000000000
000000000000000