000000000000000
444444444444444
000000000000000
333333333333330
000000000000000
033333333333333
000000000000000
022222222222222
000000000000000
222222222222220
000000000000000
011111111111111
000000000000000
111111111111110
000000000000000