100000000000002
010000000000020
001000000000200
000100000002000
000010000020000
000001000200000
000000102000000
000000050000000
000000304000000
000003000400000
000030000040000
000300000004000
003000000000400
030000000000040
300000000000004