000000000000000
000000000000000
011111111111110
000222222222000
000003333300000
000000444000000
000000050000000
000000444000000
000003333300000
000222222222000
011111111111110
000000000000000
000000000000000
000000000000000
000000000000000