000100000001000
001010000010100
010001000100010
100000101000001
000000000000000
000000020000000
000000200000000
000002000000000
000022222220000
000000000000000
033000000000330
000300000003000
000033333330000
000000000000000
000000000000000