000000000000000
000000000000000
000110000011000
000110000011000
000000000000000
011000000000110
000100000001000
000011111110000
000000000000000
000000000000000
000000000000000
000000000000000
000000000000000
000000000000000
000000000000000