000000000000000
000000000000000
000000000000000
000000000000000
011111111111110
010000000000010
010222222222010
010200000002010
010203333302010
010204444402010
010200000002010
010222202222010
010000000000010
011111101111110
000000000000000