000000000000000
000000000000000
002220000022200
003333000333300
004444444444400
000444444444000
000044444440000
000005555500000
000000555000000
000000010000000
000000000000000
000000000000000
000000000000000
000000000000000
000000000000000