000000000000000
000000000000000
000220000022000
000220000022000
000000000000000
044000000000440
000400000004000
000044444440000
000000000000000
000000000000000
000000000000000
000000000000000
000000000000000
000000000000000
000000000000000