000000000000000
022220000022220
033333000333330
044444444444440
001111111111100
000111111111000
000011111110000
000001111100000
000000111000000
000000010000000
000000000000000
000000000000000
000000000000000
000000000000000
000000000000000