555555555555555
050000000000050
005000000000500
000500000005000
000050000050000
000005000500000
000000505000000
000000050000000
000000505000000
000005000500000
000050000050000
000500000005000
005000000000500
050000000000050
555555555555555